3
20 7 1
####################
#222222222222222222D
#222222222222222222#
#222B22222222222222#
#2222S2222222222222#
#222222222222222222#
####################
2 1


20 7 2
####################
D222222#22222222222#
#222222#22222222222D
#222222#22222222222#
#2222S2#22222222222#
#222222222222222222#
####################
1 1
3 1

20 7 2
####################
#222222#22222222222#
D222222#2222222B222#
#222222#22222222222#
#2222S2#22222222222#
#222222222222222222#
####################
2 2
